ws		"[ \t\n]+"
com 		"//.*\n"
com		"/\*.*\*/"

if		"if"
then		"then"
else		"else"
to		"to"
do		"do"
lambda		"\\"
name		"[a-zA-Z]+"
argument	"\$[0-9]+"
number		"-?[0-9]+"
string		"["][^"]*["]"
all		"@"
all		"\.\.\."
hash		"#"
star		"\*"
otherwise	"\|"
arrow		"->"
tunnel		">>"
opencurly 	"{"
closecurly 	"}"
equal		"="
openang		"<"
closeang	">"
opensq		"\["
closesq		"]"
openparen	"\("
closeparen	"\)"
colon		":"
